S # # # # # # # # #
. . . . . . . . . .
. # # # # . # # # .
. # . # . . . . # .
. # . # . # # . # .
. . . # . # # # # .
. # . # . . . . . .
. # . # . # . # # .
. # . . . # # # # .
. . . . # . . . . .
# # # # # # # # # E